15
20
50
SSSSSSSSSSSSSSSSSSSS
SSSSSSSSSSSSSSSSSSSS
SSSSSSSSSWWWSSSSSSSS
SSSSSSSSWWWWWSSSSSSS
SSSSSSSWWWSSWWWSSSSS
SSSSSSWWSSSSSWWWSSSS
SSSSSWWSSSSSSSWWWWSS
SSSSSWWSSSSSSSSWWWSS
SSSSSSWWWSSSSSSSWWSS
SSSHSSSWWWSSSSSSWWSS
SSSHSSSSSWWWSSSWWWSS
SSHSHSSSSSWWWWWWWWSS
SSSSSSSSSSSWWWSSSSSS
SSSSSSSSSSSSSSSSSSSS
SSSSSSSSSSSSSSSSSSSS