30
40
50
HHHHHHHHHHHHHHHHHHHHHHHHHHHHHHHHHHHHHHHH
HHHHHHHHHHHHHHHHHHHHHHHHHHHHHHHHHHHHHHHH
HHHHHHHHHHHHHHHHHHHHHHHHHHHHHHHHHHHHHHHH
HHHHHHHHHHHHHHHHHHHGGHHHHHHHHHHHHHHHHHHH
HHHHHHHHHHHHHHHHHHGGGGHHHHHHHHHHHHHHHHHH
HHHHHHHHHHHHHHHHHGGGGGGGHHHHHHHHHHHHHHHH
HHHHHHHHHHHHHHHHHGGGGGGGHHHHHHHHHHHHHHHH
HHHHHHHHHHHHHHHHHHGGGGGGGHHHHHHHHHHHHHHH
HHHHHHHHHHHHHHHHHHHSSSSSSHHHHHHHHHHHHHHH
HHHHHHHHHHHHHHHHHHSSWWWWSSSHHHHHHHHHHHHH
HHHHHHHHHHHHHHHHHSSWWWWWWSSSHHHHHHHHHHHH
HHHHHHHHHHHHHHHHHSSSWWWWWSSSHHHHHHHHHHHH
HHHHHHHHHHHHHHHHHHSSWWWWWWSSSHHHHHHHHHHH
HHHHHHHHHHHHHHHHHHSSSWWWWWSSSHHHHHHHHHHH
HHHHHHHHHHHHHHHHHHHSSSSSSSSSSHHHHHHHHHHH
HHHHHHHHHHHHHHHHHHHHHHSSSSSSSSSHHHHHHHHH
HHHHHHHHHHHHHHHHHHHHHHHSSSSSSSSSHHHHHHHH
HHHHHHHHHHHHHHHHHHHHHHHHHHHHHHHHHHHHHHHH
HHHHHHHHHHHHHHHHHHHHHHHHHHHHHHHHHHHHHHHH
HHHHHHHHHHHHHHHHHHHHHHHHHHHHHHHHHHHHHHHH
HHHHHHHHHHHHHHGGGHHHHHHHHHHHHHHHHHHHHHHH
HHHHHHHHHHHHHGGGGGGHHHHHHHHHHHHHHHHHHHHH
HHHHHHHHHHHHGGGGGGGHHHHHHHHHHHHHHHHHHHHH
HHHHHHHHHHHHGGGGGGHHHHHHHHHHHHHHHHHHHHHH
HHHHHHHHHHHHHHGGGHHHHHHHHHHHHHHHHHHHHHHH
HHHHHHHHHHHHHHHHHHHHHHHHHHHHHHHHHHHHHHHH
HHHHHHHHHHHHHHHHHHHHHHHHHHHHHHHHHHHHHHHH
HHHHHHHHHHHHHHHHHHHHHHHHHHHHHHHHHHHHHHHH
HHHHHHHHHHHHHHHHHHHHHHHHHHHHHHHHHHHHHHHH
HHHHHHHHHHHHHHHHHHHHHHHHHHHHHHHHHHHHHHHH
HHHHHHHHHHHHHHHHHHHHHHHHHHHHHHHHHHHHHHHH